11111111111111111111
1P1000000000100000C1
10101111110C00111111
101000000111111000C1
10100+00110000001111
10111110100011000001
10000010100111111111
1C0+0010101100+00001
1000000000C0010001C1
10111111111011111111
10C0000000+0000000E1
11111111111111111111