11111111111111111111
1P000001E10000000001
11110000000000100001
1000+010100111100001
101110101001000+0001
101C1010110100000001
1C1000101C01C0000001
11101010111100000001
1000101000C10+000001
11111011111100011111
1C0000000000C10000C1
11111111111111111111