1111111111111111111
10000C01E100C000001
11110+00P0000000001
1000001010010100001
101110101C010001111
1010101011010001C01
1C1001101001+000001
11101C1011110001001
10+0001000C10001001
1110111111110101111
10000000000001000C1
1111111111111111111