11111111111111111111
1P1000000000100000C1
10101111110C00111111
101000000111111000C1
10100000110000001111
10111110100011000001
10000010100111111111
1C000010101100000001
1000000000C0010001C1
1C111111111111111111
10C000000000000000E1
11111111111111111111