1111111111111111111
100C0C01E100C000001
11110000P0000000001
100C001010010100001
1011101010010001111
1010101011010001001
1C10011010010000C01
1110101011110001001
1000001000C10001001
1110101111110101111
1C00000C000001000C1
1111111111111111111