1111111111111111111111111111111111
1EC00000000000C00000C0000000000001
1C1001010010000100100100C000010101
1000010011101010001001000000010101
10P001001CC0C0000000000000C00000C1
1111111111111111111111111111111111